1111111111
1001000000001
100001
1P0010000000
11
