11111
1P001
10001
10011
11001
11101
1E101
10101
10101
10101
10001
100C1
11111
